20
20
# player 0
0 0
# player 1
0 1
# player 2
19 19
# player 3
19 18
# npc team 1
4 3
# npc team 2
17 16
# map
....................
....................
.c............c.....
....................
WWWWWWWWWWWWWWWWWWWW
WWWWWWWWWWWWWWWWWWWW
....................
......c.............
....................
..............c.....
