15
15
0
0
14
0
0
14
14
14
# map
.s...........ww
.s...t.t.t...ww
.s..t.t.t.t....
.s....b........
.s......h.b....
.s..h...s...h..
.s.....rs..b...
.s......s..tttt
.s......dddd...
.s..h......d.b.
.s.....rt..d...
.s.r.r.....d...
.s.....t.t.d...
dsddddddddddddd
dsddddddddddddd
