15
15
0
0
14
14
0
14
14
0
# map
.s..........www
.s..........www
.s..........www
.s..........www
.s.....h.......
.s.........b...
.s.....r.......
.s.........tttt
.s......dddd...
.s...r.....d.b.
.s.....r...d...
.s.........d...
.s.........d...
dsddddddddddddd
dsddddddddddddd
